12
1,5,7,5,5,6,1,5,7,7,7,6
3,5,14,3,6,9,7,6,10,9,12,10
10,2,10,10,9,6,10,10,10,3,6,10
10,9,12,10,2,9,12,10,10,10,10,10
9,6,3,12,11,5,4,10,11,12,9,14
3,12,9,5,14,3,7,12,9,5,4,10
9,7,6,2,10,9,12,3,7,5,5,14
3,12,11,14,10,3,6,8,9,5,6,10
10,2,10,10,11,14,9,5,5,7,14,10
10,9,13,13,13,12,3,5,7,14,9,14
11,5,5,7,7,6,10,3,13,15,6,10
9,5,4,9,12,9,13,13,5,12,9,12
