12
1,5,7,7,4,3,7,5,6,3,5,6
2,3,12,11,5,12,9,6,11,13,6,10
10,9,5,14,3,5,6,11,13,6,11,14
11,7,4,10,8,3,14,9,6,9,14,10
11,14,3,12,3,12,8,3,13,7,12,10
10,10,9,5,14,3,7,12,1,12,3,14
10,11,7,6,10,9,12,3,5,7,12,10
10,9,12,10,9,6,3,13,7,14,3,12
9,6,3,13,6,10,9,5,12,10,10,2
3,15,13,7,14,9,5,5,7,12,10,10
11,12,1,14,11,5,5,4,11,5,13,14
9,5,5,12,9,5,5,5,13,5,5,12
