12
1,5,7,5,6,1,6,3,7,5,7,4
3,5,12,2,9,7,13,12,11,5,15,6
10,3,5,13,6,9,5,5,13,6,8,10
10,10,3,5,12,3,7,5,6,9,6,10
10,10,11,7,5,12,10,2,9,5,12,10
10,10,10,9,6,3,14,11,5,6,3,14
9,12,10,3,14,9,12,11,5,12,10,10
3,6,10,10,8,3,5,14,3,5,12,10
10,11,14,9,5,13,6,11,12,3,6,10
9,15,14,3,7,6,9,13,4,10,9,14
3,13,12,10,10,9,7,6,3,14,2,10
9,5,5,13,12,1,12,9,12,8,9,12
