12
1,5,5,5,7,7,5,5,4,3,7,6
3,7,5,6,10,11,7,4,3,12,10,8
11,12,3,12,9,12,9,7,12,2,11,6
9,6,10,3,7,5,6,11,5,12,8,10
3,14,10,10,11,5,13,15,7,5,5,14
9,14,9,12,10,3,6,10,10,1,5,12
2,10,3,5,12,9,13,12,9,5,5,6
10,10,10,3,5,5,7,7,7,7,6,10
10,10,11,13,4,3,14,8,9,14,9,14
11,13,13,4,3,12,11,7,5,12,3,12
9,6,3,6,11,6,9,12,3,4,9,6
1,13,12,9,13,12,1,5,13,5,5,12
