12
1,5,6,3,5,6,3,4,3,5,7,6
3,5,13,12,3,14,9,5,12,3,14,10
9,4,3,7,12,9,5,5,6,9,14,10
3,5,14,11,6,3,5,7,13,7,14,10
11,6,11,12,9,13,4,11,6,9,13,14
11,12,10,3,6,3,6,10,9,7,6,8
11,6,10,10,10,11,12,10,1,14,9,6
10,10,10,8,10,10,1,13,5,13,4,10
10,10,10,3,14,9,5,6,3,5,5,14
8,10,10,10,9,7,7,12,10,3,5,14
3,12,10,10,3,12,9,5,13,13,6,10
9,5,13,12,9,5,5,5,5,5,13,12
