12
1,5,7,4,3,5,5,7,5,5,7,6
3,5,13,5,12,3,5,12,3,5,12,10
11,7,7,7,6,10,3,5,12,3,5,14
10,10,10,10,9,12,11,6,1,15,5,14
11,12,10,9,6,1,12,10,3,13,5,14
9,6,10,3,12,3,6,10,9,7,5,14
3,13,12,11,7,13,12,9,5,15,7,14
11,6,3,12,9,7,7,7,6,11,12,8
11,12,11,5,6,10,10,10,11,13,7,6
10,3,13,6,11,12,10,10,8,3,14,10
9,14,2,9,13,5,14,9,5,12,11,14
1,12,9,5,5,5,13,5,5,5,13,12
