12
1,5,7,6,3,5,6,3,5,5,7,6
1,7,15,13,12,2,9,14,1,6,10,10
3,15,13,7,7,15,7,13,7,13,14,10
8,10,3,12,9,15,13,6,10,3,12,10
3,12,9,6,2,9,4,11,14,10,3,12
11,5,5,13,12,3,6,11,14,10,9,6
9,5,7,7,5,13,12,8,10,9,6,10
3,7,14,11,5,5,7,5,13,6,9,14
10,10,8,11,7,5,12,1,5,12,3,12
10,9,5,12,10,3,7,5,5,6,11,6
9,7,6,2,11,12,11,6,2,9,12,10
1,12,9,13,13,5,13,13,13,5,5,12
