12
1,5,5,6,1,7,7,5,6,3,6,2
3,5,6,11,5,12,10,3,14,10,11,12
10,1,13,12,1,5,13,14,11,13,15,6
11,5,5,5,5,7,6,10,9,6,11,14
11,7,7,4,3,12,9,12,3,12,9,14
11,14,9,6,10,3,7,6,10,3,4,10
10,9,5,15,14,9,12,9,12,10,3,12
9,7,7,13,15,5,7,5,5,14,10,2
3,12,11,7,13,5,14,3,5,12,10,10
10,3,13,14,3,6,10,9,5,4,10,10
9,12,3,12,9,14,11,5,5,6,10,10
1,5,13,5,5,13,13,5,4,9,13,12
