12
1,5,5,7,5,5,6,3,5,5,5,6
3,7,5,15,7,7,13,13,6,3,5,12
8,10,3,14,8,10,3,4,10,11,7,6
3,12,10,9,5,14,11,7,13,12,8,10
11,6,9,5,5,13,14,10,1,7,5,14
11,13,5,5,6,3,14,9,6,11,5,12
10,1,7,6,10,9,12,3,14,11,5,6
9,7,15,14,11,5,7,13,13,14,3,14
2,10,10,10,10,3,14,3,5,12,10,8
9,13,15,15,12,9,12,9,6,3,13,6
3,5,12,9,6,3,7,4,10,8,3,14
9,5,5,4,9,12,9,5,13,5,12,8
