12
1,5,7,5,5,5,6,1,7,5,5,6
2,3,13,6,3,4,10,3,12,3,6,8
10,11,4,10,10,3,13,12,3,12,9,6
9,12,3,12,11,12,2,3,13,7,7,14
3,5,12,3,13,5,12,10,1,12,9,14
11,5,5,14,2,3,6,9,5,6,2,10
11,5,6,9,12,9,13,5,7,12,11,12
10,2,9,5,5,7,5,5,12,3,12,2
11,12,2,3,5,13,5,6,3,13,7,14
11,5,14,10,3,5,5,14,9,6,10,10
10,3,14,10,10,1,5,13,7,12,8,10
9,13,13,12,9,5,5,5,13,5,5,12
